00xxxx011110011000001000111000
011110011110100001110000111000
011110011110011001110000111000
011110000000100001110000000000
00000000000000000000xxxxxxx100
00000111000x000111000000000000
00000111000x000111000000000000
00000111000x000111000000000000
00000000000x000000000000000000
111000000000000000000000011100
111000000000000000000000011100
111000000000000000000000011100
000000011110011000001000111000
011110011110100001110000111000
011110011110011001110000111000
011110000000100001110000000000
00000000000000000000xxxx000100
00000111000x000111000000000000
00000111000x000111000000000000
00000111000x000111000000000000
00000000000x000000000000000000
111000000000000000000000011100
111000000000000000000000011100
111000000000000000000000011100
000000000000000000000000000000
111000000000000000000000011100
111000000000000000000000011100
111000000000000000000000011100
000000000000000000000000000000
000000000000000000000000000000