011111001110011000001000111000
011111001110100001110000111000
011111001110011001110000111000
011111000000100001110000000000
00000000000000000000xxxxxxx100
00000111000x000111000000000000
00000111000x000111000000000000
00000111000x000111000000000000
00000000000x000000000000000000
111000000000000000000000011100
111000000000000000000000011100
111000000000000000000000011100
000000011100011000001000111000
011100011100100001110000111000
011100011100011001110000111000
011100000000100001110000000000
00000000000000000000xxxx000100
00000111000x000111000000000000
00000111000x000111000000000000
00000111000x000111000000000000
00000000000x000000000000000000
111000000000000000000000011100
111000000000000000000000011100
111000000000000000000000011100
000000000000000000000000000000
111000000000000000000000011100
111000000000000000000000011100
111000000000000000000000011100
000000000000000000000000000000
000000000000000000000000000000